11111111
1P000001
10000001
10C00001
1000E001
11110111