11111
100E1
10111
10001
11101
1P001
11111