11111
10E01
10111
10001
11101
1P001
11111