111111111111111111111111111111111111
10000000010100010001000000000E000001
100000000101010101010000000000000001
100000000101010101010000000000000001
100000000101010101010000000000000001
100000000001010101010000000000000001
100000000101010101010000000000000001
100000000101010101010000000000000001
1CC000000101010101010000000000000001
1PC000000100010001000000000000000001
111111111111111111111111111111111111