1111111111111111111111111
1P100010001000100010C01E1
1000100010001000100010001
1111111111111111111111111