11111111111111111111
1P10001000100001C0E1
10001000100001000001
11111111111111111111