1111111111111111111111111111111
10000000010100010001000000000E1
1000000001010101010100000000001
1000000001010101010100000000001
1000000001010101010100000000001
1000000000010101010100000000001
1000000001010101010100000000001
1000000001010101010100000000001
1CC0000001010101010100000000001
1PC0000001000100010000000000001
1111111111111111111111111111111