1111111111111111111
10010100010001000E1
1001010101010100001
1001010101010000001
1001010101010000001
1000010101010000001
1001010101010000001
1001010101010100001
1CC0010101010000001
1PC0000100010000001
1111111111111111111