1111111111111111111111111111111
10000000010000000000000000001E1
1001000001000000000000000000101
1001000001000000000000000000001
1001000001000000000000000000001
1001000001000000000000000000001
1001000000000000000000000000001
1001000001000000000000000000001
1CC1000001000000000000000000001
1PC1000001000000000000000000001
1111111111111111111111111111111