11111
100E1
10111
1C001
11101
1P101
11111