1111111111111111111111111111111
10000000010000000000000000000E1
1000000001000000000000000000001
1000000001000000000000000000001
1000000001000000000000000000001
1000000001000000000000000000001
1000000001000000000000000000001
1000000001000000000000000000001
1CC0000001000000000000000000001
1PC0000001000000000000000000001
1111111111111111111111111111111