1111111111111111111111111111111
100000000C0000000000001000001E1
10001011111111100100001000001C1
1000100000000010010000111100101
100010TTT0000011111110100000001
1000100000000000100000100111111
111010000C000001010111000000001
1000111111111111101010100000001
1P10000000GGGG000010000000000C1
1111111111111111111111111111111