11111111111111111111
1P10001000100001C0E1
100010001I00N1000001
11111111111111111111